            +-------------+                 +-------------+                 +-------------+                 +-------------+                                                                                                          
            |.............|                 |.............|                 |.............|                 |.............|                                                                                                          
            |.............|                 |.............|                 |.............|                 |.............|                                                                                                          
            |.............|                 |.............|                 |.............|                 |.............|                                                                                                          
            |.............|                 |.............|                 |.............|                 |.............|                                                                                                          
            +------#------+                 +------#------+                 +------#------+                 +------#------+                                                                                                          
                   #                               #                               #                               #                                                                                                                 
                   #                               #                               #                               #                                                                                                                 
                   #                               #                               #                               #                                                                                                                                                                                    
                   #                               #        ############           #                               #                                                                                                                                                                                  
                   #                               #        #                      #                               #                                                                                                                                                                            
                   ################                #        #                      #                               #                                                                               +--------------------------------+
                   #              #                #        #                      #                               #                                                                               |................................|
                   #              #                #        #                      #                               #                                                                               |................................|
                   #              #                #################################################################                                                                               |................................|
                   #              #                #                   #           #                               #                                                                               |................................|
                   #              #                #                   #           #                               #                                                                               |................................|
                   #              #                #                   #           #                               #                                                                               |................................|
                   #              #                #          ##########           #                               #                                                                               |................................|
                   #              #                #                               #                               #                                                                               |................................|
                   #              #                #                               #                               #################################################################################................................|
                   #              #                #                               #                               #                                                                               |................................|
                   #              #                #                               #                               #                                                                               |................................|
                   #              #                #                               #        ########################                                                                               |................................|
                   #              ##########################################       #               #               #                                                                               |................................|
                   #                               #                #              #               #               #                                                                               |................................|
                   #                               #                #              #               #               #                                                                               |................................|
                   #                               #                #              #               #               #                                                                               |................................|
                   #                               #                #              #               #               #                                                                               |................................|
                   #                               #                #              #               #               #                                                                               +--------------------------------+
                   ##################################################              #               #               #                                                                                                                 
                   #                               #                #              #               #               #                                                                                                                 
                   #                               #                #              #               #               #                                                                                                                 
                   #                               #                #              #               #               #                                                                                                                 
                   #                               #                ################################               #                                                                                                                 
            +------#------+                 +------#------+                 +------#------+        #        +------#------+                                                                                                          
            |.............|                 |.............|                 |.............|        #        |.............|                                                                                                          
            |.............|                 |.............|                 |.............|        #        |.............|                                                                                                          
            |.............|                 |.............|                 |.............|        #        |.............|                                                                                                          
            |.............|                 |.............|                 |.............|        #        |.............|                                                                                                          
            +-------------+                 +-------------+                 +-------------+        #        +-------------+                                                                                                          